1 1 1 1 1 1 1 1 1 1 1 1 1 1 1 1
1 0 6 2 2 2 2 2 2 0 0 0 0 0 0 1
1 0 0 0 0 2 2 0 0 0 0 0 0 0 0 1
1 0 0 0 0 0 0 0 0 0 0 0 0 0 0 1
1 0 0 0 0 0 0 0 0 0 0 0 0 0 0 1
1 0 0 0 0 0 0 0 0 1 1 1 0 0 0 1
1 0 0 0 0 0 0 0 0 1 6 2 2 2 0 1
1 0 1 1 1 0 0 0 0 1 6 2 2 2 0 1
1 0 2 2 1 0 0 0 3 3 6 2 2 2 0 1
1 0 2 2 1 0 0 0 3 3 6 6 6 6 0 1
1 0 0 0 0 0 0 0 0 0 0 3 3 3 0 1
1 1 1 1 1 1 1 1 1 1 1 1 1 1 1 1